111111111111111111111111111111111111111
1000000C0000010000000C00000100010000001
10010000000001000000000010000000C000001
10000000001000000P000000000010000000001
1010E0010000010000010001000000000000001
100000010000000010000000000100000010001
100000C0000010000000001000C000100000001
100000000000010000C00000000000000100001
111111111111111111111111111111111111111