111111111111111
1PCCCCCCCCCCCE1
111111111111111