111111111111111111
10010C1P1100000E11
110001101001C11111
11100000001100C111
1111111111P1111111