1111111111111111111111111111111111
10000000000000000000000000X0000001
1010010100100000101001000000010101
101001001010100E001001000000010101
1P0000000C00C000000000000X00000001
1111111111111111111111111111111111